11111111111
11000000011
10010110111
10010000101
11000110001
11111111111