    NO      ./path_to_the_north_textureN     
SO     ./path_to_the_south_textureS


F	2,34,44  

   EA ./path_to_the_east_textureE   

WE ./path_to_the_west_textureW

   C 255,255,255

  
          111111111  
11111111111000000011111111
10000000S11111110000000001
111111000000011111100000111111
111111111111111111111111
1000000000000000000000001
111111111110001111111111
           111

     11111111
     10000011
      111111