    NO      ./path_to_the_north_textureN     
SO     ./path_to_the_south_textureS


F	2,34,44  
   C 255,255,255

   EA ./path_to_the_east_textureE   
WE ./path_to_the_west_textureW



 11111111
1N00001
10000001111111
1111111