    NO      ./path_to_the_north_textureN     
SO     ./path_to_the_south_textureS


F	2,34,44  
   C 245,180,130   

   EA ./path_to_the_east_textureE   
WE ./path_to_the_west_textureW


               1111111
1111111111111111N000001
10000000000001000000101
1000000000000000000001
1000000111111111111111
1111111