    NO      ./path_to_the_north_textureN
SO     ./path_to_the_south_textureS
WE ./path_to_the_west_textureW
   EA ./path_to_the_east_textureE


F 25, 30  , 230
   C      255,65,27

                 1111111111111111111111111
               1110000000110000000000001
                  10110000111111111111111111111111
11111111111111111110000001
1111111110110000011100001
100000000011000001110111111111111
11110111111111011100000010001
11110111111111011101010010001
11000000110101011100000010001
10000000000000001100000010001111111
1000000000000000110101001000000000001
11000001110101011111011110N01111111111
11111111 1111111 111111111111 11111111 1111111 111111111111