    NO     textures/N1.xpm
SO     textures/door.xpm


F	26,56,130  

   EA textures/mini_wall.xpm   

WE textures/file.xpm  

   C 120,56,130

  
 1
1N1
 1

1111
