    NO     textures/N1.xpm
SO     textures/S1.xpm


   EA textures/E1.xpm   

WE textures/W1.xpm
F 40,70,20
   C 120,56,130
      
111111
  1111
  1S11 
111111111
111111